060080420
015060378
000400060
100604830
306010705
080350000
830940000
072130900
009020610